wwwwwwwwwwwwwwwwwww
wDFFwFFFFfffFFFfFFw
wFffwFFCCCwFFfffFFw
wFFfwFFccCwFFCCcCFw
wFFFffFCcCwFFCCcCFw
wFFFffFFFFFwfcCCCFw
wwwwwwwwwwwwwwwwwww